1111111111111
1E1000C0001C1
100P000001001
10100L0000011
1C0L00C00L011
1111111111111