1111111111111
10100C00001C1
1E0P0000C1001
1010000000011
1000C00000011
1111111111111